111111111111
1000P0000E01
100000000001
100000000001
1000C0000001
100000000001
111111111111
