1111111111111111111111
100000000000000000E001
100000000000C000000001
100000000000C000000001
100000000000C000e00001
100000e00000C000000001
100000000000C000000001
100000000000C000000001
100000000000C0e0000001
100000000000C000000001
1000e0000000C000e00001
100000000000C000000001
100000000000C000000001
1000000P00000000000001
1111111111111111111111
