111111111111111111111
111111111111111111111
111111011100000111111
111110011011111011111
111101011111111011111
111011011111100111111
110000001110011111111
111111011101111111111
111111011000000011111
111111111111111111111
10000000000CC00000001
1P000000000CC000000E1
10000000000CC00000001
111111111111111111111
