11111111111111111111111
100000000000000000E0001
100000000000C0000000001
100000000000C0000000001
100000000000C000e000001
100000e00000C0000000001
100000000000C0000000001
100000000000C0000000001
100000000000C00e0000001
100000000000C0000000001
1000e0000000C0000000001
100000000000C0000000001
100000000000C0000000001
1000000P000000000000001
11111111111111111111111
