1111111111111
1P00000000001
10C00100E0001
1111111101111
1000000000001
1111101101111
10C0000000011
1111111111111
